 --- --- --- --- --- --- --- --- --- 
|   |       |       |               |
                         ---         
|       |       |   |   | x |       |
 ---     ---                 ---     
| >     |       |       |       |   |
     ---     --- --- ---     ---     
|   |       |       |           |   |
                         ---         
|       |       |       |           |
 --- --- --- --- --- --- --- --- --- 