 --- --- --- --- --- --- --- --- --- 
|   |       |       |               |
                         ---         
|       |       |   |   | x |       |
 ---     ---                 ---     
| >     |       |       |           |
     ---     --- --- --- --- ---     
|   |       |       |           |   |
                         ---         
|       |       |       |           |
 --- --- --- --- --- --- --- --- --- 