 --- --- --- --- --- --- --- --- --- 
|                                   |
                                     
|                                   |
                                     
| <   x                             |
                                     
|                                   |
                                     
|                                   |
 --- --- --- --- --- --- --- --- --- 