 --- --- --- --- --- --- --- --- --- 
| v |               |               |
         ---             --- ---     
|   |   |   |       |   |           |
         --- ---             --- --- 
|   |           |   |   |   |       |
     ---                             
|       |       |       |   | x |   |
         ---     --- ---     ---     
|               |                   |
 --- --- --- --- --- --- --- --- --- 