 --- --- --- --- --- --- --- --- --- 
| v |               |               |
         ---             --- ---     
|   |   |   |           |           |
         --- ---                 --- 
|   |           |   |   | x |       |
     ---         ---                 
|       |       |       |   |   |   |
         ---         ---     ---     
|               |                   |
 --- --- --- --- --- --- --- --- --- 