 --- --- --- --- --- --- --- --- --- 
|       |       |       |       |   |
                                     
|   |   |   |   |   |   |   |   |   |
                                     
| v |       |       |       |     x |
                                     
|   |   |   |   |   |   |   |   |   |
                                     
|       |       |       |       |   |
 --- --- --- --- --- --- --- --- --- 