 --- --- --- --- --- --- --- --- --- 
|               |                   |
     ---                 ---         
|           |           |   |       |
 ---             --- ---     ---     
|       |   |   |                   |
         ---     --- --- ---         
|                                   |
                                     
| x                         |     > |
 --- --- --- --- --- --- --- --- --- 