 --- --- --- --- --- --- --- --- --- 
|               |                   |
     ---                 ---         
| > |   |   |   | x     |           |
 ---             --- ---     --- --- 
|       |       |                   |
             --- --- --- --- ---     
|   |       |           |           |
     --- ---         ---     ---     
|               |           |       |
 --- --- --- --- --- --- --- --- --- 