 --- --- --- --- --- --- --- --- --- 
|               |                   |
     ---                 ---         
|           |           |   |       |
 ---             --- ---     ---     
|       |   |   | <                 |
         ---     --- --- ---         
|   |                   |           |
         ---         ---     ---     
| x |           |           |       |
 --- --- --- --- --- --- --- --- --- 