 --- --- --- --- --- --- --- --- --- 
| <                                 |
 --- --- --- --- --- --- --- ---     
|                               |   |
     --- --- --- --- --- ---         
|   |                     x |   |   |
         --- --- --- --- ---         
|   |                           |   |
     --- --- --- --- --- --- ---     
|                                   |
 --- --- --- --- --- --- --- --- --- 