 --- --- --- --- --- --- --- --- --- 
| v                                 |
                                     
|                                   |
                                     
|                                   |
                                     
|                                   |
                                     
|                                 x |
 --- --- --- --- --- --- --- --- --- 