 --- --- --- --- --- --- --- --- --- 
| x |               |               |
         ---             --- ---     
|   |   |   |           |           |
         --- ---                 --- 
|   |           |   |   |   |       |
     ---         ---                 
|       |       |       |   |   |   |
         ---         ---     ---     
|               |                 < |
 --- --- --- --- --- --- --- --- --- 