 --- --- --- --- --- --- --- --- --- 
|               |                 x |
     ---                 ---         
|           |           |   |       |
 ---             --- ---     ---     
|       |   |   |                   |
         ---     --- --- ---         
|   |                   |           |
         ---         ---     ---     
| v |           |           |       |
 --- --- --- --- --- --- --- --- --- 