 --- --- --- --- --- --- --- --- --- 
|               |                   |
     ---                 ---         
|           |           |   | x     |
 ---             --- ---     --- --- 
|       |   |   |                   |
         --- --- --- --- ---         
|   |                   |           |
         ---         ---     ---     
|   |           |           | ^     |
 --- --- --- --- --- --- --- --- --- 